21 21
XXXXXXXXXXXXXXXXXXXXX
Xs......X...X.......X
XXX.X.X.X.X.X.XXXXX.X
X...X.X...X.X.X...X.X
X.X.XXX.XXXXX.X.X.X.X
X.X...X.......X.X...X
X.XXXXX.XXXXXXX.XXXXX
X.X...X.X.....X.....X
X.X.X.X.X.X.X.X.XXX.X
X.X.X...X.X.X.X.X...X
X.XXX.XXXXX.X.X.X.XXX
X.X.X.X...X.X.X.X...X
X...X.XXX.X.XXX.XXXXX
X.X.X.X.X.......X...X
XXX.X.X.XXXXXXX.X.X.X
X.X.X.X...X.X.X.X.X.X
X.X.XXXXXXX.XXX.X.X.X
X...X...X.X.X.....X.X
XXX.XXX.X.X.X.XXXXX.X
X.........X.X.....XeX
XXXXXXXXXXXXXXXXXXXXX
